w: 24
h: 24
x: 12
y: 3
111111111111111111111111
100000000000000000000001
100000000000000001111101
100000000000000001000101
100000110000000001000101
100000110000000001101101
100000111100000000000001
100000001100000000000001
100000001100000000000001
100000000000000000000001
100000000000000000000001
100010101000000011110001
100000000000000011110001
100010101000000000000001
100000000000000000000001
100001100000001100000001
100001000000000010000001
100001000000000001000001
100001100001000000110001
100000000010100000110001
100000000100010000000001
100000000000000000000001
100000000000000000000001
111111111111111111111111